######################################
######################################
##''''''''''''''''''''''''''''''''''##
##''''''''''''''''''''''''''''''''''##
##''''''''''''''''''''''''''''''''''##
##''''''''''''''''''''''''''''''''''##
##''''''''''''''''''''''''''''''''''##
##''''''''''''''''''''''''''''''''''##
##''''''''''''''''''''''''''''''''''##
##''##''##''''''''''''''''##''''''''##
##''##''#########''#########''''''''##
##''##''####''''''''''''####''''''''##
##''##''####''''''''''''####''''''''##
##''##''####''###''###''####''''''''##
##''##''''''''#''''''#''''''''''''''##
##''##''''''''#''''''#''''''''''''''##
##''####''##################''####''##
''''''''''''''''''''''''''''''''''''''
''''''''''''''''''''''''''''''''''''''
##''####''##################''####''##
##''#''''''''''''''''''''''''''''#''##
##''#''''''''''''''''''''''''''''#''##
##''#''''''''''''''''''''''''''''#''##
##''#''''''''''''''''''''''''''''#''##
##''#''''''''''''''''''''''''''''#''##
##''#''''''''''''''''''''''''''''#''##
##''#''''''''''''''''''''''''''''#''##
##''#''''''''''''''''''''''''''''#''##
##''#''''''''''''''''''''''''''''#''##
##''#''''''''''''''''''''''''''''#''##
##''##############''##############''##
##''''''''''''''''''''''''''''''''''##
##''''''''''''''''''''''''''''''''''##
##''#######''############''#######''##
##''''''''''''''''''''''''''''''''''##
##''''''''''''''''''''''''''''''''''##
######################################
######################################